40:40
7000000111111110111111110111111101111111
1111110111111110111111110111111101111111
1111110111111110111111110111111101111111
1111110111111110111111110111111101111111
0000000000000000000000000000000000111111
1111110111110111101110111110111110111111
1111110111110111101110111110111110000000
1111110111110111101110111110111110111111
1111110111110111101110111110111110111111
1111110111110111101110111110111110111111
0000000111110000001110111110111110111111
1111110111110111101110000000000000111111
1111110111110111101110111110111110111111
1111110111110111101110111110111110111111
1111110111110111101110111110111110000000
1111110000000111100000111110111110111011
1111110111110111111110111110111110111011
1111110111110111111110111110111110111011
1111110111110000000000000000000000111011
0000000111110111111111011111110111111011
1110111111110111111111011111110111111011
1110111111110111111111011111110110000000
1110111111110111111111011111110110111111
1110111111110000000000000011110110111111
1110000000000111111011111011110000000111
1111110111011111111011111011111110110111
1111110111011111111011111011111110110111
1111110111011111111011111000000000110111
1111110111011111111011111011111111110111
1111110111001111111011111011111111110111
0000000111101111111000000000000111110000
1111011111100000111011111011110000000111
1111011111101110111011111011111111111111
1111011111101110011011111011111111111111
1111000000001111011011111011111111111111
1111101111011111011011111000000000000000
1111101111011111000001111011111101111111
1111101111000000011101111011111101111111
1111101111111111111101111011111101111111
1111101111111111111101111011111101111111