40:40
7000000011111111101111111110111111111111
1111111011111111101111111110111111111111
1111111011111111101111111110111111111111
1111111011111111101111111110000000011111
1111111000000000000020011110111111111111
1111111011111111101111011110111111111111
1111111011111111101111011110000001111111
1111111011111111101111011110111101111111
0000000011111111101111011110111101111111
1111111000000111100000011110000001111111
1111111011110111101111011110111111111111
1111111011110000001111011110111111111111
1111111011110111101111011110111111111111
1111111011110111101111011110111111111111
1111111011110111101111011110111111111111
0000000011110111100000000000000000011111
1111111111110111101111011110111111011111
1111111111110111101111011110111111011111
1111111111110111101111011110111111011111
1111111111110111101111011110111111011111
0000000000000000001111011110111111011111
1111111111110111101111000000111111011111
1111111111110111101111011110111111011111
1111000011110111101111011110000000011111
1111011011110111101111011110111101111111
1111011011110111101111011110111101111111
1111000000000000000000011110111101111111
1111011111011111101111000000111101111111
1111011111011111101111011110111101111111
1111011111011111101111011110000001111111
1111000000300000001111011110111101111111
1111110111110111111111011110111101111111
1111110111110111111111011110111101111111
1111110111110111111111000000111100011111
0000000111110111111111011111111101111111
1111000000300000001111011110111101111111
1111110111110111111111011110111101111111
1111110111110111111111011110111101111111
1111110111110111111111000000111100011111
0000000111110111111111011111111101111111